13
12
R...R...R...R
.............
.WW.BBSBB.WW.
.............
.....WWW.....
..B..WWW..B..
..B.......B..
.............
S...BBSBB...S
.............
.....BBB.....
..G..BFB..G..