18
13
....B..III......BF
........III..BG.SB
..B...B..III.BB...
..........III...B.
....S...B..III..S.
............III...
BSBB...B..S..III..
R.............III.
.....B...B.....III
BBR....S....S...II
.....B...........I
R....S..B......B..
..R..B.RB.........