16
13
.......W........
.......W..BsB..R
....B..W........
....s.....BsB..R
G...B.W.........
BB....W...BsB..s
FB....W.........
BB....W...BsB..s
G...B.W.........
....s.....BsB..R
....B.W.........
......W...BsB..R
......W.........