17
17
R..WWWWWWWWWWW..R
.................
.................
W..SBBBBBBBBBS..W
W..B.........B..W
W..B.BBBBBBB.B..W
W..B.BIIIIIB.B..W
W..B.BISBSIB.B..W
W..BGBIBFBIBGB..W
W..B.BISBSIB.B..W
W..B.BIIIIIB.B..W
W..B.BBBBBBB.B..W
W..B.........B..W
W..SBBBBBBBBBS..W
.................
.................
R..WWWWWWWWWWW..R