23
9
.......W.....W....SS..G
.R.....W.....W.........
.......W.....W.........
...R.W...WW....W....sBB
R......W.....W......sBF
...R.W...WW....W....sBB
.......W.....W.........
.R.....W.....W.........
.......W.....W....SS..G