15
15
BBB.........BBB
BBB.........BBB
BBB...SWS...BBB
...............
....R.....R....
...............
..S...BBB...S..
..W...BGB...W..
..S...BBB...S..
...............
....R.....R....
...............
BBB...SWS...BBB
BBB.........BBB
BBB.........BBF