17
12
.R.R.R.....R.R.R.
WWWWWWWW.WWWWWWWW
.................
.WWWWWWWWWWWWWWW.
.......SSS.......
WW.....SSS.....WW
.......SSS.......
WWWW...BFB...WWWW
IIIWWWWWWWWWWWIII
IIIIIIIIIIIIIIIII
IIIIIIIIIIIIIIIII
IIIIIIIIGIIIIIIII